#####..#####
##........##
#.#.@....#.#
#..#....#..#
#...#..#...#
............
............
#...#..#...#
#..#....#..#
#.#......#.#
##........##
#####..#####