#####..#####
#..........#
#..........#
####....####
#..........#
..@..##.....
.....##.....
#..........#
####....####
#..........#
#..........#
#####..#####