############
##........##
#.#.@....#.#
#..#....#..#
#...#..#...#
#..........#
#..........#
#...#..#...#
#..#....#..#
#.#......#.#
##........##
############