................................
................................
................................
................................
....#########...................
............#...................
.....#...@..#...................
.....#####..##..................
.....#..........................
.......#........................
......###.......................
.......#........................
................................
.....###........................
.##....#........................
.##.............................
