................
................
................
................
....#########...
............#...
.....#......#...
.....#####..##..
.....#..........
.......#........
......###.......
.......#........
................
.....###........
.##....#........
.##.............
