#..##..#
........
........
........
........
........

######..
........
........
........
........
........

..######
........
........
........
........
........

###..###
........
........
........
........
........

#.#.#.#.
........
........
........
........
........

.#.#.#.#
........
........
........
........
........

#...F..#
........
........
........
........
........

...##...
........
........
........
........
........

..#@#...
........
........
........
........
........

@@@###..
........
........
........
........
........

..#@#...
........
........
........
........
........

@@@###..
........
........
........
........
........

..#@#...
........
........
........
........
........

@@@###..
........
........
........
........
........

..#@#...
........
........
........
........
........

@@@###..
........
........
........
........
........

........
........
........
........
........
........